49;50;51;52;53;54;75;76;81
48;47;46;45;44;55;74;77;80
37;38;39;40;43;56;73;78;79
36;35;34;41;42;57;72;71;70
31;32;33;14;13;58;59;68;69
30;17;16;15;12;61;60;67;66
29;18;19;20;11;62;63;64;65
28;25;24;21;10;1;2;3;4
27;26;23;22;9;8;7;6;5
